XXXXXX
XOXXXX
X XXFX
X XXFX
X XXFX
XXXXXX