XXXXXX
XOXXXX
X*FX X
XXFX X
XFFFFX
XXXXXX