XXXXX     
X O X
X X X
X X X
X   X
  X
 XXX
  X
X F X  
XXXXX