XXXXXXXXX
X O     X
X X XXX X
X X X   X
X   X X X
  X     X
 XXX XX X
  X     X
X   X X X
XXXF  F X